R 1080 720

C 70,52,235
F 30,105,5

EA bonus/texture/grass.xpm
NO bonus/texture/brick.xpm
WE bonus/texture/wood2.xpm
SO bonus/texture/sassiblu.xpm
S  bonus/texture/ptero.xpm

111111111111111111111111111
1000000202001100000000000001
10000100200200000200110020001
1000000110200000000110000001
1111111110000111111111211001
     1100000000000000000200011
      1100111100001111111100111
1111111110011100011     10011
1000020000110100011     10011
10010002010000001111111110011
10100000001000001111111110111
10004W000000030011002000101
10100000001000011000020101
100100000100000001100020101
110000011011111111110111101
110000000000000000000000021
111111111111111111111111111