R 1080 800

C 21,34,56
F 43,83,41

EA bonus/texture/grass.xpm
NO bonus/texture/brick.xpm
WE bonus/texture/wood2.xpm
SO bonus/texture/sassiblu.xpm
S bonus/texture/ptero.xpm

111111111111111111111111111111
103000000000001120000000000001
100111001111100001111100111001
100111021111100001111100111001
100000000000001100003000000201
100111001001111111100100111001
102000001000001100000100000001
111001001111001100111100100111
100001000302000000000200100001
100111001020000002000100111001
10000000100000N400000100002001
100111001002000000000100111001
100001001020000000202100100001
111001001001111111100100100111
100000300000000000000000000001
100111001111001100111100111001
100001000000001102000030100001
111001001001111111100100100111
100000001000001100000100000001
100111001111001100111100111001
100200000000003000000000002001
111111111111111111111111111111